MMMMMMMMMMMMMMMMMMMMMMMMM
MFFFFFFFFFFFFFFFFFFFFFFFM
MFFFMFFFMMMMMMMMMFFFFFFFM
MFFFMFFPPPPPPPPFFFFFFFFFM
MFFFMMMMMFFFFFFFFFFFFFFFM
MFFFFFFFFFFFFFFFFFFFFBFFM
MFFFFFFFFFFFFFFFFFFFFFFFM
MFFFFFFFFFFFFFFFFFFFFFFFM
MFFFFFFFBFFFFFFFFFFFFFFFM
MFFFFFFFFFFFFFFFFFFFFFFFM
MFFFFFFFFFFFFFFFFFFFFFFFM
MFFFFFFFFFFFFFFFFFFFFFFFM
MFFFFFFFFMMFFMMFFFFFFFFFM
MFFFFFFFFMFFFFMFFFFFFFFFM
MFFFFFFFFMMMMMMFFFFFFFFFM
MFFFFFBFFFFFFFFFFFFFFFFFM
MFFFFFFFFFFFFFFFFFFFFFFFM
MFFFFFFFFFFFFFFFFFFFFFFFM
MFFFFFFFFFFFFFFFFFFFFFFFM
MFFFFFFFFFFFFFFFFFFFBFFFM
MFFFFFFFFFFFFFFFFFFFFFFFM
MFFFPFFFFFFFFFFFFFFFFFFFM
MFFFFFFFFFFFFFFFFFFFFFFFM
MFFFFFFFFFFFFPFFFFFFFFFFM
MFFFFFFFFFFFFFFFFFFFFFMFM
MFFFFFFFFFFFFFFFFFFFFFMFM
MFFBFFFFFFFFFMMMMMMMFFMFM
MFFFFFFFFFFFFMFFFPMFFFMFM
MFFFFFFFFFFFFMFFMFFFMFFFM
MMMMMMMMMMMMMMMMMMMMMMMMM