MMMMMMMMMMMMMMMMMMMMMMMMM
MGGGGGGGGGGGGGGGGGGGGGGGM
MGGGMGGGMMMMMMMMMGGGGGGGM
MGGGMGGGGGGGGGGGGGGGGGGGM
MGGGMMMMMGGGGGGGGGGGGGGGM
MGGGGGGGGGGGGGGGGGGGGSGGM
MGGGGGGGGGGGGGGGGGGGGGGGM
MGGGGGGGGGGGGGGGGGGGGGGGM
MGGGGGGGSGGGSGGGGGGGGGGGM
MGGGGGGGGGGGGGGGGGGGGGGGM
MGGGGGGGGGGGGGGGGGGGGGGGM
MGGGGGGGGGGGGGGGGGGGGGGGM
MGGGGGGGGMMGGMMGGGGGGGGGM
MGGGGGGGGMGGGGMGGGGGGGGGM
MGGGGGGGGMMMMMMGGGGGGGGGM
MGGGGGSGGGGGGGGGGGGGGGGGM
MGGGGGGGGGGGGGGGGGGGGGGGM
MGGGGGGGGGGGGGGGGGGGGGGGM
MGGGGGGGGGGGGGGGGGGGGGGGM
MGGGGGGGGGGGGGGGGGGGSGGGM
MGGGGGGMMMMMMMMMMGGGGGGGM
MGGGSGGGGGGGGGGGMGGGGGGGM
MGGGGGGGGGMMMGMMMGGGGGGGM
MGGGGGGGGGMGGPMGGGGGGGGGM
MGGGGGGGGGMMMMMMMMGGGGMGM
MGGGGGGGGGGGGGGGGGGGGGMGM
MGGSGGGGGGGGGMMMMMMMGGMGM
MGGGGGGGGGGGGMGGGPMGGGMGM
MGGGGGGGGGGGGMGGMGGGMGGGM
MMMMMMMMMMMMMMMMMMMMMMMMM