MMMMMMMMMMMMMMMMMMMMMMMMM
MGGGGGMGGGGGGGGGGGGGGGGGM
MGMMMGMGMMMMMMMMMMMMMMMGM
MGGGMGGGGGGGGGGGGGGGGGGGM
MGGGMMMMMGGGGGGGGGGGGGGGM
MGGGGGGGGGGGGGGGGGGGGSGGM
MGGGGGGGGGGGGGGGGGGGGGGGM
MGGGGGGGGGGGGGGGGGGGGGGGM
MGGGGGGGSGGGSGGGGGGGGGGGM
MGGGGGGGGGGGGGGGGGGGGGGGM
MGGGGGGGGGGGGGGGGGGGGGGGM
MGGGGGGGGGGGGGGGGGGGGGGGM
MGGGGGGGGMMGGMMGGGGGGGGGM
MGGGGGGGGMGGGGMGGGGGGGGGM
MGGGGGGGGMMMMMMGGGGGGGGGM
MGGGGGSGGGGGGGGGGGGGGGGGM
MGGGGGGGGGGGGGGGGGGGGGGGM
MGGGGGGGGGGGGGGGGGGGGGGGM
MGGGGGGGGGGGGGGGGGGGGGGGM
MGGGGGGGGGGGGGGGGGGGSGGGM
MGGGGGGMMMMMMMMMMGGGGGGGM
MGGGSGGGGGGGGGGGMGGGGGGGM
MGGGGGGGGGMMMGMMMGGGGGGGM
MGMGMGMMMGMGGPMGGGGGGGGGM
MGMGMGGGMGMMMMMMMMGGGGMGM
MGMGMMMGMGGGGGGGGGGGGGMGM
MGMSGGGGMGGGGMMMMMMMGGMGM
MGMMMMMMMMMMGMGGGPMGGGMGM
MGGGGGGGGGGGGMGGMGGGMGGGM
MMMMMMMMMMMMMMMMMMMMMMMMM